Dozen = Düzine
Supposition = Varsayım
Acquaintance = Tanış
Neglect = İhmal Etmek
Satisfactory = Tatminkar
Vain = Boşuna
Currosity = Merak
Favourable = Olumlu
Approach = Yaklaşım
Occasion = Fırsat
Attendant = Görevli
Overwhelm = Boğulmak
Contrast = Zıtlık
Plain = Sade
Arrogant = Kibirli
Striking = Çarpıcı
Elegant = Şık
Patio = Veranda
Brief = Kısa
Reign = Saltanat
Dynasty = Hanedan
Prominence = Öne Çıkmak
Realm = Krallık
Reside = İkamet etmek
Occupy = İşgal Etmek
Significant = Kayda Değer
Consist = Oluşmak
Consistent = Tutarlı
Consistency = Tutarlılık
Betrohted = Nişanlı
Cucumber = Salatalık
Jug = Sürahi
Cereal = Kahvaltılık Gevrek
Rectangle = Dörtgen
